8 8
0 0 1 1 1 0 0 0
0 0 1 4 1 0 0 0
0 0 1 2 1 1 1 1
1 1 1 3 2 3 4 1
1 4 2 3 6 1 1 1
1 1 1 1 3 1 0 0
0 0 0 1 4 1 0 0
0 0 0 1 1 1 0 0
