10 10
1 1 1 1 1 1 1 1 1 1
1 2 2 2 2 2 2 2 2 1
1 2 1 1 1 2 2 2 2 1
1 2 1 4 1 2 2 2 2 1
1 2 1 3 1 2 2 2 2 1
1 2 1 7 1 2 6 2 2 1
1 2 2 2 2 2 2 2 2 1
1 2 2 2 2 2 2 2 2 1
1 2 2 2 2 2 2 2 8 1
1 1 1 1 1 1 1 1 1 1
