11 8
0 0 0 0 0 0 1 1 1 1 1
0 0 0 0 0 0 1 4 2 2 1
0 0 0 0 0 0 1 4 1 2 1
1 1 1 1 1 1 1 4 1 2 1
1 2 6 2 3 2 3 2 3 2 1
1 2 1 2 1 2 1 2 1 1 1
1 2 2 2 2 2 2 2 1 0 0
1 1 1 1 1 1 1 1 1 0 0
Level 4: Not so hard
