11 15
1 1 1 1 1 1 1 1 1 1 1
1 1 1 1 1 1 1 8 1 2 1
1 2 2 2 2 2 1 7 1 2 1
1 2 1 1 1 2 1 8 1 2 1
1 2 1 4 1 2 1 2 1 2 1
1 2 1 3 1 2 2 3 2 2 1
1 2 1 8 1 2 6 2 2 7 1
1 2 1 7 1 2 2 2 1 8 1
1 2 2 2 2 2 2 2 1 7 1
1 2 2 2 2 2 2 2 1 4 1
1 1 1 1 1 1 1 1 1 2 1
1 2 2 4 2 2 2 2 1 2 1
1 2 3 3 5 2 2 2 2 2 1
1 2 4 2 2 2 2 2 2 2 1
1 1 1 1 1 1 1 1 1 1 1